##############
# H #  ####  #
# ####22##  #
# 12# 3##  #
###1# ##  #
#     1   #
##########