#############
#           #
#    ###    #
#    #      #
#    ###    #
#      #    #
#    ###    #
#H5         #
#############